3786294#5
##9##176#
####4###8
###18##9#
##2##4#57
##65372##
#1#2##5##
#57#####1
9#431#67#